bmol_acsf_minimal_int_rr	acsf-s
bmol_acsf_minimal_int_krr	acsf-s_krr
bmol_acsf_minimal_ext_rr	acsf-s_ext
bmol_acsf_minimal_ext_krr	acsf-s_ext_krr
bmol_acsf_smart_int_rr	acsf
bmol_acsf_smart_int_krr	acsf_krr
bmol_acsf_smart_ext_rr	acsf_ext
bmol_acsf_smart_ext_krr	acsf_ext_krr
bmol_acsf_longrange_int_rr	acsf-l
bmol_acsf_longrange_int_krr	acsf-l_krr
bmol_acsf_longrange_ext_rr	acsf-l_ext
bmol_acsf_longrange_ext_krr	acsf-l_ext_krr
bmol_cm_sorted_l2_rr	cm_l2
bmol_cm_sorted_l2_krr	cm_l2_krr
bmol_cm_eigenspectrum_rr	cm_eigspec
bmol_cm_eigenspectrum_krr	cm_eigspec_krr
bmol_ecfp4_krr	ecfp4_krr
bmol_ecfp4_rr	ecfp4
bmol_ecfp6_krr	ecfp6_krr
bmol_ecfp6_rr	ecfp6
bmol_gylm_minimal_int_krr	gylm-s_krr
bmol_gylm_standard_int_krr	gylm_krr
bmol_gylm_minimal_ext_krr	gylm-s_ext_krr
bmol_gylm_standard_ext_krr	gylm_ext_krr
bmol_gylm_minimal_int_rr	gylm-s
bmol_gylm_standard_int_rr	gylm
bmol_gylm_minimal_ext_rr	gylm-s_ext
bmol_gylm_standard_ext_rr	gylm_ext
bmol_mbtr_int_rr	mbtr
bmol_mbtr_int_krr	mbtr_krr
bmol_mbtr_ext_rr	mbtr_ext
bmol_mbtr_ext_krr	mbtr_ext_krr
bmol_pdf_soap_standard_rr	pdf_soap
bmol_pdf_gylm_standard_rr	pdf_gylm
bmol_pdf_soap_standard_krr	pdf_soap_krr
bmol_pdf_gylm_standard_krr	pdf_gylm_krr
bmol_pdf_soap_minimal_rr	pdf_soap-s
bmol_pdf_gylm_minimal_rr	pdf_gylm-s
bmol_pdf_soap_minimal_krr	pdf_soap-s_krr
bmol_pdf_gylm_minimal_krr	pdf_gylm-s_krr
bmol_physchem_basic_rf	physchem_rf
bmol_physchem_basic_rr	physchem
bmol_physchem_core_rf	physchem_core_rf
bmol_physchem_core_rr	physchem_core
bmol_physchem_logp_rf	physchem_logp_rf
bmol_physchem_logp_rr	physchem_logp
bmol_physchem_extended_rf	physchem_extended_rf
bmol_physchem_extended_rr	physchem_extended
bmol_soap_minimal_nocross_int_krr	soap-s_krr
bmol_soap_minimal_cross_int_krr	soap-s-crs_krr
bmol_soap_smart_nocross_int_krr	soap_krr
bmol_soap_smart_cross_int_krr	soap-crs_krr
bmol_soap_longrange_nocross_int_krr	soap-l_krr
bmol_soap_longrange_cross_int_krr	soap-l-crs_krr
bmol_soap_minimal_nocross_ext_krr	soap-s_ext_krr
bmol_soap_minimal_cross_ext_krr	soap-s-crs_ext_krr
bmol_soap_smart_nocross_ext_krr	soap_ext_krr
bmol_soap_smart_cross_ext_krr	soap-crs_ext_krr
bmol_soap_longrange_nocross_ext_krr	soap-l_ext_krr
bmol_soap_longrange_cross_ext_krr	soap-l-crs_ext_krr
bmol_soap_minimal_nocross_int_rr	soap-s
bmol_soap_minimal_cross_int_rr	soap-s-crs
bmol_soap_smart_nocross_int_rr	soap
bmol_soap_smart_cross_int_rr	soap-crs
bmol_soap_longrange_nocross_int_rr	soap-l
bmol_soap_longrange_cross_int_rr	soap-l-crs
bmol_soap_minimal_nocross_ext_rr	soap-s_ext
bmol_soap_minimal_cross_ext_rr	soap-s-crs_ext
bmol_soap_smart_nocross_ext_rr	soap_ext
bmol_soap_smart_cross_ext_rr	soap-crs_ext
bmol_soap_longrange_nocross_ext_rr	soap-l_ext
bmol_soap_longrange_cross_ext_rr	soap-l-crs_ext
bxtal_acsf_minimal_int_rr	acsf-s
bxtal_acsf_minimal_int_krr	acsf-s_krr
bxtal_acsf_minimal_ext_rr	acsf-s_ext
bxtal_acsf_minimal_ext_krr	acsf-s_ext_krr
bxtal_acsf_smart_int_rr	acsf
bxtal_acsf_smart_int_krr	acsf_krr
bxtal_acsf_smart_ext_rr	acsf_ext
bxtal_acsf_smart_ext_krr	acsf_ext_krr
bxtal_acsf_longrange_int_rr	acsf-l
bxtal_acsf_longrange_int_krr	acsf-l_krr
bxtal_acsf_longrange_ext_rr	acsf-l_ext
bxtal_acsf_longrange_ext_krr	acsf-l_ext_krr
bxtal_esm_sorted_l2_rr	esm_sorted_l2
bxtal_esm_sorted_l2_krr	esm_sorted_l2_krr
bxtal_esm_eigenspectrum_rr	esm_eigspec
bxtal_esm_eigenspectrum_krr	esm_eigspec_krr
bxtal_gylm_minimal_int_krr	gylm-s_krr
bxtal_gylm_standard_int_krr	gylm_krr
bxtal_gylm_minimal_ext_krr	gylm-s_ext_krr
bxtal_gylm_standard_ext_krr	gylm_ext_krr
bxtal_gylm_minimal_int_rr	gylm-s
bxtal_gylm_standard_int_rr	gylm
bxtal_gylm_minimal_ext_rr	gylm-s_ext
bxtal_gylm_standard_ext_rr	gylm_ext
bxtal_mbtr_int_rr	mbtr
bxtal_mbtr_int_krr	mbtr_krr
bxtal_mbtr_ext_rr	mbtr_ext
bxtal_mbtr_ext_krr	mbtr_ext_krr
bxtal_pdf_soap_standard_rr	pdf_soap
bxtal_pdf_gylm_standard_rr	pdf_gylm
bxtal_pdf_soap_standard_krr	pdf_soap_krr
bxtal_pdf_gylm_standard_krr	pdf_gylm_krr
bxtal_pdf_soap_minimal_rr	pdf_soap-s
bxtal_pdf_gylm_minimal_rr	pdf_gylm-s
bxtal_pdf_soap_minimal_krr	pdf_soap-s_krr
bxtal_pdf_gylm_minimal_krr	pdf_gylm-s_krr
bxtal_physchem_s05_rf	physchem_s05_rf
bxtal_physchem_s05_rr	physchem_s05
bxtal_physchem_s10_rf	physchem_s10_rf
bxtal_physchem_s10_rr	physchem_s10
bxtal_physchem_s20_rf	physchem_s20_rf
bxtal_physchem_s20_rr	physchem_s20
bxtal_soap_minimal_nocross_int_krr	soap-s_krr
bxtal_soap_minimal_cross_int_krr	soap-s-crs_krr
bxtal_soap_smart_nocross_int_krr	soap_krr
bxtal_soap_smart_cross_int_krr	soap-crs_krr
bxtal_soap_longrange_nocross_int_krr	soap-l_krr
bxtal_soap_longrange_cross_int_krr	soap-l-crs_krr
bxtal_soap_minimal_nocross_ext_krr	soap-s_ext_krr
bxtal_soap_minimal_cross_ext_krr	soap-s-crs_ext_krr
bxtal_soap_smart_nocross_ext_krr	soap_ext_krr
bxtal_soap_smart_cross_ext_krr	soap-crs_ext_krr
bxtal_soap_longrange_nocross_ext_krr	soap-l_ext_krr
bxtal_soap_longrange_cross_ext_krr	soap-l-crs_ext_krr
bxtal_soap_minimal_nocross_int_rr	soap-s
bxtal_soap_minimal_cross_int_rr	soap-s-crs
bxtal_soap_smart_nocross_int_rr	soap
bxtal_soap_smart_cross_int_rr	soap-crs
bxtal_soap_longrange_nocross_int_rr	soap-l
bxtal_soap_longrange_cross_int_rr	soap-l-crs
bxtal_soap_minimal_nocross_ext_rr	soap-s_ext
bxtal_soap_minimal_cross_ext_rr	soap-s-crs_ext
bxtal_soap_smart_nocross_ext_rr	soap_ext
bxtal_soap_smart_cross_ext_rr	soap-crs_ext
bxtal_soap_longrange_nocross_ext_rr	soap-l_ext
bxtal_soap_longrange_cross_ext_rr	soap-l-crs_ext
